# actuator/motor
pwr2pwm	KEYWORD2
motorSetup	KEYWORD2
rawMotorCtrl	KEYWORD2
RCC_MOTOR_ENA	LITERAL1		RESERVED_WORD_2
RCC_MOTOR_ENB	LITERAL1		RESERVED_WORD_2
RCC_MOTOR_IN1	LITERAL1		RESERVED_WORD_2
RCC_MOTOR_IN2	LITERAL1		RESERVED_WORD_2
RCC_MOTOR_IN3	LITERAL1		RESERVED_WORD_2
RCC_MOTOR_IN4	LITERAL1		RESERVED_WORD_2

# actuator/servo
RCC_SERVO_PIN	LITERAL1		RESERVED_WORD_2

# sensor/hc-sr04
HC_SR04	KEYWORD1		DATA_TYPE
HC_SR04_async	KEYWORD1		DATA_TYPE
begin	KEYWORD2
duration2distance	KEYWORD2
duration2meters	KEYWORD2
duration2centimeters	KEYWORD2
duration2feet	KEYWORD2
duration2inches	KEYWORD2
getDuration	KEYWORD2
isDone	KEYWORD2
pulse	KEYWORD2
RCC_ECHO_PIN	LITERAL1		RESERVED_WORD_2
RCC_TRIG_PIN	LITERAL1		RESERVED_WORD_2
RCC_HC_SR04_TIMEOUT_US	LITERAL1		RESERVED_WORD_2
RCC_SOUND_METERS_PER_MICROSECOND	LITERAL1		RESERVED_WORD_2
RCC_SOUND_CENTIMETERS_PER_MICROSECOND	LITERAL1		RESERVED_WORD_2
RCC_SOUND_FEET_PER_MICROSECOND	LITERAL1		RESERVED_WORD_2
RCC_SOUND_INCHES_PER_MICROSECOND	LITERAL1		RESERVED_WORD_2

# sensor/mpu6050
MPU6050	KEYWORD1		DATA_TYPE
begin	KEYWORD2
calibrate	KEYWORD2
getAccel	KEYWORD2
getAccelX	KEYWORD2
getAccelY	KEYWORD2
getAccelZ	KEYWORD2
getAngVel	KEYWORD2
getAngVelX	KEYWORD2
getAngVelY	KEYWORD2
getAngVelZ	KEYWORD2
getTemp	KEYWORD2
update	KEYWORD2
RCC_MPU6050_I2C_ADDR	LITERAL1		RESERVED_WORD_2

# sensor/odom
Odom	KEYWORD1		DATA_TYPE
begin	KEYWORD2
getLeftCount	KEYWORD2
getRightCount	KEYWORD2
RCC_LEFT_ENCODER_PIN	LITERAL1		RESERVED_WORD_2
RCC_RIGHT_ENCODER_PIN	LITERAL1		RESERVED_WORD_2

# util/array
ARRAYSIZE	KEYWORD3		PREPROCESSOR

# util/differentiator
Differentiator	KEYWORD1		DATA_TYPE
differentiate	KEYWORD2
reset	KEYWORD2
setTimeParameters	KEYWORD2

# util/pid-control
PID_control	KEYWORD1		DATA_TYPE
PID_control_config_t	KEYWORD1		DATA_TYPE
pd	KEYWORD2
pid	KEYWORD2
setDeadbands	KEYWORD2
setGains	KEYWORD2
setTimeParameters	KEYWORD2
setpointReset	KEYWORD2
